     A = ASC
     B = TAN
     C = SIN
     D = SGN
     E = RETURN
     F = FRE
     G = LEN
     H = VAL
     I = STR$
     J = STOP
     K = CONT
     L = LOAD
     M = LOG
     N = ATN
     O = DEF
     P = PEEK
     Q = NEXT
     R = RND
     S = SAVE
     T = RESTORE
     U = CHR$
     V = COS
     W = STEP
     X = LET 
     Y = READ
     Z = DIM
     0 = POKE
     1 = FOR
     2 = THEN
     3 = GOSUB
     4 = GOTO
     5 = INPUT
     6 = DATA
     7 = LEFT$
     8 = MID$
     9 = RIGHT$
     : = USR
     - = INT
   RUB = LIST
 RETURN = RUN
    LF = REM
 SPACE = PRINT
     > = NOT
     < = AND
     / = TAB(
     ; = END
     . = EXP
     , = SQR
     ? = SPC(
     + = CLEAR
   ESC = cancel keyword mode